XXXXXXXXXXXXXXXXXXXXXXXXXXXXXXX
X                             X
X                         D   X
X    XXXX                     X
X    XXXX                     X
X              XXXX           X
X              XXXX           X
X                             X
X            XXXXXXX          X
X            XXXXXXX          X
X                             X
X                             X
X@                            X
XXXXXXXXXXXXXXXXXXXXXXXXXXXXXXX
