XXXXXXXXXX
X@       X
X        X
X        X
XXXXXXX  X
XXXXXXX  X
X        X
X XXXXXXXX
X        X
X    D   X
X        X
XXXXXXXXXX